31 10
bbbbbbbbbbbbbbbbbbbbbbbbbbbbbbb
b                            ab
b         b                   b
b          b                  b
b          b                  b
b          b   b              b
b          b                  b
b              b              b
bs                 t          b
bbbbbbbbbbbbbbbbbbbbbbbbbbbbbbb
19 8 29 2