bbbbbbbbbbbbbbbbbbbbbbbbbbbbbbb
b                             b
b         b                   b
b          b                  b
b          b                  b
b          b   b              b
b          b                  b
b              b              b
bs                            b
bbbbbbbbbbbbbbbbbbbbbbbbbbbbbbb