1 10
bbbbbbbbbb
b      gqb
b      bbb
b        b
b        b
b        b
b        b
b     bbbb
bs   go lb
bbbbbbbbbb
8 1 6 8